00000000000000000000000000
00000000000000000000000000
00BB000000BB00BB000000BB00
00BB00BB00BB00BB00BB00BB00
00BB00BB00BB00BB00BB00BB00
00BB00BB00BB00BB00BB00BB00
00BB00BB00BB00BB00BB00BB00
00BB00BB00BB00BB00BB00BB00
00BB00BB0000000000BB00BB00
00BB00BB0000000000BB00BB00
0000000000BB00BB0000000000
0000000000BB00BB0000000000
0000BBBB0000000000BBBB0000
0000BBBB0000000000BBBB0000
0000000000BB00BB0000000000
0000000000BBBBBB0000000000
00BB00BB00BBBBBB00BB00BB00
00BB00BB00BB00BB00BB00BB00
00BB00BB00BB00BB00BB00BB00
00BB00BB0000000000BB00BB00
00BB00BB0000000000BB00BB00
00BB00BB000BBBB000BB00BB00
00000000000B00B00000000000
00000000000B00B00000000000